You are known to be a highly-skilled female agent, and are therefore given the task of capturing the head of an organization that is threatening the people of Aerugo. Unfortuanately for you, Mr. Zakarius kind of-sort of lost your equipment on the way. After you and your teammate have successfully taken care of the entrance guards and picking the front door lock (and after you have successfully fumed for a full five minutes), you must make your way through  the temporary HQ to the center, where the boss is located.

capture you
An Interactive Fiction by Nicole Baptist
Release 1 / Serial number 141022 / Inform 7 build 6L38 (I6/v6.33 lib 6/12N) SD

Entrance
A petite room with black and white checkerboard-style tiles, and grey walls. There is a plant on either side of the doorway, and a three narrow windows. The exit is to the north.

I beg your pardon?

>n
I
You listen through the door to make sure no one's guarding the other side. . .Nope. You carefully slip past the threshold into the first room. You see a few lockers here. You assume they are for the guards. It is The exit is to the west and back south.

Roy follows you here.

>w
II
The exit is to the west and back east.

Roy follows you here.

>e
I
You listen through the door to make sure no one's guarding the other side. . .Nope. You carefully slip past the threshold into the first room. You see a few lockers here. You assume they are for the guards. It is The exit is to the west and back south.

Roy follows you here.

>x lockers
A simple set of lockers. To open them you must spin the dial to the correct number.  (Hint: when entering the numbers, type them in as a single number.)

>spin dial to 507
"CLICK" The lockers are now unlocked. You can see handcuffs.

>open lockers
It isn't something you can open.

>take handcuffs
Taken.

>w
II
The exit is to the west and back east.

Roy follows you here.

>w
III
The exit is to the north and back east.

Roy follows you here.

>s
V
___. You see a section of the room blocked off by a rope.

Roy follows you here.

>x rope
You untie the rope from the poles and take it with you.

* * *

>eat red m&m
You can't see any such thing.

>n
I
You'll have to say which compass direction to go in.

>w
II
You'll have to say which compass direction to go in.

>w
III
You'll have to say which compass direction to go in.

>n
IV room
What appears to be the guards" break room. A simple, clean room with a few tables and chairs for the base's security guards to rest on. There is a counter along the wall across the door. Apparently it is not break time yet.

You can see Tables, Chairs and Cigarette pack (closed) here.

You'll have to say which compass direction to go in.

>x tables
You scan the tables to check for any clues the guards carelessly left behind. Unfortunately, there are no clues to be found.

You'll have to say which compass direction to go in.

>x chairs
You check each chair for anything that might have fallen out of the guards" pockets. On one chair, you find a pack of cigaretts. You pocket the pack.

You'll have to say which compass direction to go in.

>x cigarette pack
"Hey, you found cigarettes! Mind sharing?" asks Roy.

You'll have to say which compass direction to go in.

* * *

>n
I
You listen through the door to make sure no one's guarding the other side. . .Nope. You carefully slip past the threshold into the first room. You see a few lockers here. You assume they are for the guards. It is The exit is to the west and back south.

Roy follows you here.

* * *

>w
III
The exit is to the north and back east.

Roy follows you here.

>s
V
One of the walls is lined with computers-you assume that this is the makeshift HQ's research room. You see a 3D printer blocked off by a rope.

You can see 3D printer here.

Roy follows you here.

>use 3d printer
There is a sign on it that reads, "Only prints plastic swords. Use at your own risk." There is a strange sound, and out pops a plastic sword.

>take sword
Taken.

>i
You are carrying:
  Plastic sword

>s
You can't go that way.

>w
You can't go that way.

>e
VI
Roy follows you here.

>n
VII
You can see Corner table and Flower pot here.

Roy follows you here.

>n
(first opening Final door)
It seems to be locked.

* * *

>x plants
Two small potted plants. After checking the pots, you discover a bit! You put the bit in your pocket.

Roy follows you here.

>n
I
The exit is to the west and back south.

You'll have to say which compass direction to go in.

>w
II
The exit is to the west and back east.

You'll have to say which compass direction to go in.

>w
III
The exit is to the north and back east.

You'll have to say which compass direction to go in.

>n
IV room
What appears to be the guards" break room. A simple, clean room with a few tables and chairs for the base's security guards to rest on. There is a counter along the wall across the door. Apparently it is not break time yet. The exit is back south.

You can see Tables and Chairs here.

You'll have to say which compass direction to go in.

>x tables
You scan the tables to check for any clues the guards carelessly left behind. Unfortunately, there are no clues to be found.

You'll have to say which compass direction to go in.

>x chairs
You check each chair for anything that might have fallen out of the guards" pockets. On one chair, you find a pack of cigaretts. "Hey, you found cigarettes! Mind sharing?" asks Roy, as he grabs hold of the cigarette pack...along with your hand holding the pack. It appears you must give him a cigarette before he releases your hand.

You'll have to say which compass direction to go in.

>open cigarette pack
"WHAT?! WHAT THE HEAK ARE THOSE M&Ms DOING IN THERE?" Roy releases you in favor of throwing his hands above his head in frustration.  You look at Roy, a blank expression plastered on your face. You see a Red M&M, a blue M&M, and a green M&M.

You'll have to say which compass direction to go in.

>x red m&m
A red M&M with a bold 1 carved into it.

You'll have to say which compass direction to go in.

>eat red m&m
That's plainly inedible.

You'll have to say which compass direction to go in.

* * *

>x plants
Two small potted plants. After checking the pots, you discover a bit! You put the bit in your pocket.

Roy follows you here.

>i
You are carrying:
  Bit

>n
I
You listen through the door to make sure no one's guarding thethe other side. . .Nope. You carefully slip past the threshold into the first room. It is The exit is to the west and back south.

Roy follows you here.

>w
II
The exit is to the west and back east.

Roy follows you here.

* * *

>w
III
The exit is to the north and back east.

Roy follows you here.

>s
V
Roy follows you here.

>e
VI
Roy follows you here.

* * *

>n
VII
You can see Corner table and Flower pot here.

Roy follows you here.

>x table
A simple corner table with a flower pot on top.

>x flower pot
A pot holding a ___. It seems unbalanced, as if something is awkwardly lifting one side.

>look under flower pot
You find a pin! You pocket the pin.

>x pin
It has a pocket that something can be inserted in through combining.

>x bit
It looks like it'd fit into something through the process of combining...

>combine pin with bit
You fit the bit into the pin and voila! Now you have a key!

>i
You are carrying:
  Key

>n
(first opening Boss door)
It seems to be locked.

>unlock boss door with key
You unlock Boss door.

>n
(first opening Boss door)

VIII
Roy follows you here.

>x roy
Roy Zakarius is your (flirtatious) colleague.

>x zakarius
Roy Zakarius is your (flirtatious) colleague.

* * *

>N
I
The exit is to the west and back south.

You'll have to say which compass direction to go in.

>W
II
You'll have to say which compass direction to go in.

>W
III
You'll have to say which compass direction to go in.

>N
IV room
What appears to be the guards" break room. A simple, clean room with a few tables and chairs for the base's security guards to rest on. There is a counter along the wall across the door. Apparently it is not break time yet.

You can see Tables and Chairs here.

You'll have to say which compass direction to go in.

>x chairs
You check each chair for anything that might have fallen out of the guards" pockets. On one chair, you find a pack of cigaretts. "Hey, you found cigarettes! Mind sharing?" asks Roy, as he grabs hold of the cigarette pack...along with your hand holding it. It appears you must give him a cigarette before he releases your hand.

You'll have to say which compass direction to go in.

>x cigarette pack
"WHAT?! WHAT THE HEAK ARE THOSE M&Ms DOING IN THERE?" Roy releases your hand in favor of throwing his hands above his head in frustration.  You look at Roy, a blank expression plastered on your face. You see a Red M&M, a blue M&M, and a green M&M.

You'll have to say which compass direction to go in.

>open cigarette pack
"WHAT?! WHAT THE HEAK ARE THOSE M&Ms DOING IN THERE?" Roy releases your hand in favor of throwing his hands above his head in frustration.  You look at Roy, a blank expression plastered on your face. You see a Red M&M, a blue M&M, and a green M&M.

You'll have to say which compass direction to go in.

>x red m&m
You can't see any such thing.

* * *

>N
I
The exit is to the west and back south.

You'll have to say which compass direction to go in.

>N
You can't go that way.

You'll have to say which compass direction to go in.

>w
II
The exit is to the west and back east.

You'll have to say which compass direction to go in.

* * *

>n
IV room
What appears to be the guards" break room. A simple, clean room with a few tables and chairs for the base's security guards to rest on. There is a counter along the wall across the door. Apparently it is not break time yet. The exit is back south.

You can see Tables and Chairs here.

You'll have to say which compass direction to go in.

>x chairs
You check each chair for anything that might have fallen out of the guards" pockets. On one chair, you find a pack of cigaretts. "Hey, you found cigarettes! Mind sharing?" asks Roy, as he grabs hold of the cigarette pack...along with your hand holding the pack. It appears you must give him a cigarette before he releases your hand.

You'll have to say which compass direction to go in.

>i
You are carrying nothing.

You'll have to say which compass direction to go in.

* * *

>x plant
Two small potted plants. After checking the pots, you discover a bit! You put the bit in your pocket.

Roy follows you here.

>i
You are carrying:
  Bit

>n
I
You listen through the door to make sure no one's guarding the other side. . .Nope. You carefully slip past the threshold into the first room. You see a few lockers here. You assume they are for the guards. It is The exit is to the west and back south.

Roy follows you here.

* * *

>use 3d printer
There is a sign on it that reads, "Only prints plastic swords. Use at your own risk." There is a strange sound, and out pops a plastic sword.

>i
You are carrying:
  Bit

>take sword
Taken.

>n
III
The exit is to the north and back east.

Roy follows you here.

>s
V
One of the walls is lined with computers-you assume that this is the makeshift HQ's research room. You see a 3D printer blocked off by a rope.

You can see 3D printer here.

Roy follows you here.

>e
VI
Roy follows you here.

* * *

>n
VII
You can see Corner table and Flower pot here.

Roy follows you here.

>look under flower pot
You find a pin! You pocket the pin.

>combine pin with bit
You fit the bit into the pin and voila! Now you have a key!

>i
You are carrying:
  Key
  Plastic sword

>n
(first opening Final door)
It seems to be locked.

>use key to unlock final door
You can't see any such thing.

>use key to unlock door
You can't see any such thing.

>use key to unlock final door
You can't see any such thing.

>unlock door with key
You unlock Final door.

>n
(first opening Final door)

VIII
Together, you and Zakarius burst through the door into the boss" room, and run to restrain him. (Fortunately for you, the guards are, apparently, still occupied.) The boss laughs (a rather disgusting laugh) and smiles. "Ah, I knew the military'd send someone for me someday...I just didn't expect you lot to find me so soon." You and Roy look at each other, remembering your mission: to bring Mr. Boss back alive for questioning.

You can see a boss here.

Roy follows you here.

>n
You can't go that way.

>w
You can't go that way.

>e
You can't go that way.

>s
VII
You can see Corner table and Flower pot here.

Roy follows you here.

>n
VIII
Together, you and Zakarius burst through the door into the boss" room, and run to restrain him. (Fortunately for you, the guards are, apparently, still occupied.) The boss laughs (a rather disgusting laugh) and smiles. "Ah, I knew the military'd send someone for me someday...I just didn't expect you lot to find me so soon." You and Roy look at each other, remembering your mission: to bring Mr. Boss back alive for questioning.

You can see a boss here.

Roy follows you here.

>n
You can't go that way.

>n
You can't go that way.

>hit boss with sword
I only understood you as far as wanting to hit the boss.

>hit boss
Violence isn't the answer to this one.

You whack the boss in the head, knocking him out.

>hit boss
Violence isn't the answer to this one.

You whack the boss in the head, knocking him out.

>hit boss with sword
I only understood you as far as wanting to hit the boss.

* * *

>x plant
Two small potted plants. After checking the pots, you discover a bit! You put the bit in your pocket.

Roy follows you here.

>n
I
You listen through the door to make sure no one's guarding the other side. . .Nope. You carefully slip past the threshold into the first room. You see a few lockers here. You assume they are for the guards. It is The exit is to the west and back south.

Roy follows you here.

* * *

>n
VII
You can see Corner table and Flower pot here.

Roy follows you here.

>look under pot
You find a pin! You pocket the pin.

>combine pin with bit
You fit the bit into the pin and voila! Now you have a key!

>unlock door
(with Key)
You unlock Final door.

>n
(first opening Final door)

VIII
Together, you and Zakarius burst through the door into the boss" room, and run to restrain him. (Fortunately for you, the guards are, apparently, still occupied.) The boss laughs (a rather disgusting laugh) and smiles. "Ah, I knew the military'd send someone for me someday...I just didn't expect you lot to find me so soon." You and Roy look at each other, remembering your mission: to bring Mr. Boss back alive for questioning.

You can see a boss here.

Roy follows you here.

>hit boss
Violence isn't the answer to this one.

* * *

>s
V
One of the walls is lined with computers-you assume that this is the makeshift HQ's research room. You see a 3D printer blocked off by a rope.

You can see 3D printer here.

Roy follows you here.

>take sword
Taken.

>e
VI
Roy follows you here.

* * *

>combine pin with bit
You fit the bit into the pin and voila! Now you have a key!

>unlock door
What do you want to unlock Final door with?

>key
You unlock Final door.

>n
(first opening Final door)

VIII
Together, you and Zakarius burst through the door into the boss" room, and run to restrain him. (Fortunately for you, the guards are, apparently, still occupied.) The boss laughs (a rather disgusting laugh) and smiles. "Ah, I knew the military'd send someone for me someday...I just didn't expect you lot to find me so soon." You and Roy look at each other, remembering your mission: to bring Mr. Boss back alive for questioning.

You can see a boss here.

Roy follows you here.

>hit boss
Violence isn't the answer to this one.

You whack the boss in the head, knocking him out.

>drop sword
Dropped.

>hit boss
Violence isn't the answer to this one.

* * *

>x plant
Two small potted plants. After checking the pots, you discover a bit! You put the bit in your pocket.

Roy follows you here.

>w
You can't go that way.

>w
You can't go that way.

>s
You can't go that way.

>n
I
You listen through the door to make sure no one's guarding the other side. . .Nope. You carefully slip past the threshold into the first room. You see a few lockers here. You assume they are for the guards. It is The exit is to the west and back south.

Roy follows you here.

* * *

>n
VII
You can see Corner table and Flower pot here.

Roy follows you here.

>look under plant
You can't see any such thing.

>look under pot
You find a pin! You pocket the pin.

* * *

>combine pin with bit
You fit the bit into the pin and voila! Now you have a key!

>unlock door with kay
You can't see any such thing.

>unlock door with key
You unlock Final door.