capture you
An Interactive Fiction by Nicole Baptist
Release 1 / Serial number 141014 / Inform 7 build 6L38 (I6/v6.33 lib 6/12N) SD

Entrance

>n
I

>w
II

>w
III

>n
IV

>s
III

>e
II

>n
You can't go that way.

* * *

>s
You can't go that way.

>w
III

>s
V

>e
VI

>n
VII

>n
VIII

>n
You can't go that way.

>s
VII

>e
You can't go that way.