You are known to be a highly-skilled female agent, and are therefore given the task of capturing the head of an organization that is threatening the people of Aerugo. Unfortuanately for you, Mr. Zakarius kind of-sort of lost your equipment on the way. After you and your teammate have successfully taken care of the entrance guards and picking the front door lock (and after you have successfully fumed for a full five minutes), you must make your way through  the temporary HQ to the center, where the boss is located.

Capture You
SECRET AGENTS YES
 by Nicole Baptist
Release 1 / Serial number 141028 / Inform 7 build 6L38 (I6/v6.33 lib 6/12N) SD

entrance
A petite room with black and white checkerboard-style tiles, and grey walls. There is a plant on either side of the doorway, and three narrow windows. The exit is to the north.

You can see Roy Zakarius here.

>N
I
You listen through the door to make sure no one's guarding the other side. . .Nope. You carefully slip past the threshold into the first room. You see a few lockers here. You assume they are for the guards. The exit is to the west and back south.

Roy follows you here.

>spin dial to 507
"CLICK" The lockers are now unlocked. You can see Handcuffs and Piece of cake.

>take cake
Taken.

>w
II
The exit is to the west and back east.

Roy follows you here.

>w
III
The exit is to the north and back east.

Roy follows you here.

>n
IV
What appears to be the guards` break room. A simple, clean room with a few tables and chairs for the base's security guards to rest on. There is a counter along the wall across the door. Apparently it is not break time yet. The exit is back south.

You can see Tables and Chairs here.

Roy follows you here.

>x chairs
You check each chair for anything that might have fallen out of the guards" pockets. On one chair, you find a pack of cigarettes with an R, a G, and a B written on the outside. Maybe it`s a code to unlock something? "Hey, you found cigarettes! Mind sharing?" asks Roy, as he grabs hold of the cigarette pack...along with your hand holding the pack. It appears you must give him a cigarette before he releases your hand. Strangely, it feels awfully light. Maybe you should check inside?

>open cigarette pack
"WHAT?! WHAT THE HEAK ARE THOSE M&Ms DOING IN THERE?" Roy releases you in favor of throwing his hands above his head in frustration.  You look at Roy, a blank expression plastered on your face. You see a green M&M, a blue M&M, and a red M&M.

>x cigarette pack
"WHAT?! WHAT THE HEAK ARE THOSE M&Ms DOING IN THERE?" Roy releases you in favor of throwing his hands above his head in frustration.  You look at Roy, a blank expression plastered on your face. You see a green M&M, a blue M&M, and a red M&M.

>s
III
The exit is to the north and back east.

Roy follows you here.

>s
V
One of the walls is lined with computers-you assume that this is the makeshift HQ's research room. You see a 3D printer blocked off by a rope.

You can see 3D printer here.

Roy follows you here.

>e
VI
You and Roy peer in through the opening made by the slightly ajar door...and see a handful of guards! So that's where they all went! If only there were a way to distract them...maybe if you placed something by the door, it`s smell would get their attention...

Roy follows you here.

>n
(first opening Hallway door)
It seems to be locked.

* * *

>w
III
The exit is to the north and back east.

Roy follows you here.

>s
V
One of the walls is lined with computers-you assume that this is the makeshift HQ's research room. You see a 3D printer blocked off by a rope.

You can see 3D printer here.

Roy follows you here.

* * *

>TALK TO ROY
You can't see any such thing.

>N
I
You listen through the door to make sure no one`s guarding the other side. . .Nope. You carefully slip past the threshold into the first room. You see a few lockers here. You assume they are for the guards. The exit is to the west and back south.

Roy follows you here.

>S
Entrance
A petite room with black and white checkerboard-style tiles, and grey walls. There is a plant on either side of the doorway, and three narrow windows. The exit is to the north.

Roy follows you here.

* * *

>talk to roy
"Do you maybe wanna grab dinner after this?"

>talk to roy
"Seriously, I know this really good Filipino place. They have the greatest adobo."

>n
I
You listen through the door to make sure no one`s guarding the other side. . .Nope. You carefully slip past the threshold into the first room. You see a few lockers here. You assume they are for the guards. The exit is to the west and back south.

Roy follows you here.

* * *

>talk to roy
"Seriously, I know this really good Filipino place. They have the greatest adobo."

>talk to roy
"So...is that a yes?" You look at Roy, a blank expression on your face, and slowly shake your head while mouthing out "no".

>talk to roy
Before Roy could open his mouth, there was a loud crashing noise from another room. He dares not talk to you for the rest of this mission.

>talk to roy
There was that crashing noise again...

>take all
There are none at all available!

>n
I
You listen through the door to make sure no one`s guarding the other side. . .Nope. You carefully slip past the threshold into the first room. You see a few lockers here. You assume they are for the guards. The exit is to the west and back south.

Roy follows you here.

>take all
There are none at all available!

>w
II
What looks like a meeting room...there are a few seats, a desk, and a whiteboard/projector screen. The exit is to the west and back east.

You can see Seats, Desk and White board here.

Roy follows you here.

>take all
There are none at all available!

>w
III
A rather empty storage room. Hmm. Must be one of their newer hideouts. The exit is to the north and back east.

You can see Boxes (closed) here.

Roy follows you here.

>take all
There are none at all available!

>n
IV
What appears to be the guards` break room. A simple, clean room with a few tables and chairs for the base`s security guards to rest on. There is a counter along the wall across the door. Apparently it is not break time yet. The exit is back south.

You can see Tables and Chairs here.

Roy follows you here.

>take all
There are none at all available!

>s
III
A rather empty storage room. Hmm. Must be one of their newer hideouts. The exit is to the north and back east.

You can see Boxes (closed) here.

Roy follows you here.

>s
V
One of the walls is lined with computers-you assume that this is the makeshift HQ`s research room. You see a 3D printer blocked off by a rope.

You can see 3D printer here.

Roy follows you here.

>take all
There are none at all available!

>e
VI
A spacious room.  All of the guards are gathered here. You can`t let them see you, as you can`t let yourself get caught. Maybe you can get them out of here if you dropped something... 

You can see Guards here.

Roy follows you here.

>take all
There are none at all available!

>n
Despite your and Roy`s exceptional skill, you don`t think you can take all of these guys at once...especially when they each have all of that equipment...

>take all
There are none at all available!

* * *

>x self
"Lookin` mighty fine today, special agent" says Roy.

Roy follows you here.

>n
I
You listen through the door to make sure no one`s guarding the other side. . .Nope. You carefully slip past the threshold into the first room. You see a few lockers here. You assume they are for the guards. The exit is to the west and back south.

Roy follows you here.

>spin dial to 507
"CLICK" The lockers are now unlocked. You can see Handcuffs and Piece of cake.

* * *

>w
III
The exit is to the north and back east.

Roy follows you here.

>s
V
One of the walls is lined with computers-you assume that this is the makeshift HQ`s research room. You see a 3D printer blocked off by a rope.

You can see 3D printer here.

Roy follows you here.

>e
VI
A spacious room.  All of the guards are gathered here. You can`t let them see you, as you can`t let yourself get caught. Maybe you can get them out of here if you dropped something... 

You can see Guards here.

Roy follows you here.

>n
Despite your and Roy`s exceptional skill, you don`t think you can take all of these guys at once...especially when they each have all of that equipment...

>drop cake
You drop half of the piece of cake and hide. The guards notice right away the delectable scent, and near the door to investigate. One of them steps forward, "Hey! My slice of cake! Actually, guys, isn`t it lunch time?" The guards take off to room IV, and you and Roy enter the code (RGB) to sneak off to the next room.

>n
That`s one heck of a piece of cake...apparently the guards are still distracted.

(first opening Hallway door)

VII
A simple hallway. The exit is back south and to the north.

You can see Corner table and Flower pot here.

Roy follows you here.

>s
VI
A spacious room. 

Roy follows you here.

>n
That`s one heck of a piece of cake...apparently the guards are still distracted.

VII
A simple hallway. The exit is back south and to the north.

You can see Corner table and Flower pot here.

Roy follows you here.

>s
VI
A spacious room. 

Roy follows you here.

* * *

>x plant
Two small potted plants. After checking the pots, you discover a bit! You put the bit in your pocket.

>i
You are carrying:
  Bit

>n
I
You listen through the door to make sure no one's guarding the other side. . .Nope. You carefully slip past the threshold into the first room. You see a few lockers here. You assume they are for the guards. It is The exit is to the west and back south.

Roy follows you here.

>w
II
The exit is to the west and back east.

Roy follows you here.

* * *

>s
V
One of the walls is lined with computers-you assume that this is the makeshift HQ's research room. You see a 3D printer blocked off by a rope.

You can see 3D printer here.

Roy follows you here.

>use 3d printer
There is a sign on it that reads, "Only prints plastic swords. Use at your own risk." There is a strange sound, and out pops a plastic sword.

>i
You are carrying:
  Bit

>take sword
Taken.

>n
III
The exit is to the north and back east.

Roy follows you here.

>s
V
One of the walls is lined with computers-you assume that this is the makeshift HQ's research room. You see a 3D printer blocked off by a rope.

You can see 3D printer here.

Roy follows you here.

>e
VI
Roy follows you here.

>n
VII
You can see Corner table and Flower pot here.

Roy follows you here.

>look under flower pot
You find a pin! You pocket the pin.

>combine pin with bit
You fit the bit into the pin and voila! Now you have a key!

>i
You are carrying:
  Key
  Plastic sword

>n
(first opening Final door)
It seems to be locked.

>use key to unlock final door
You can't see any such thing.

>use key to unlock door
You can't see any such thing.

>use key to unlock final door
You can't see any such thing.

>unlock door with key
You unlock Final door.

>n
(first opening Final door)

VIII
Together, you and Zakarius burst through the door into the boss" room, and run to restrain him. (Fortunately for you, the guards are, apparently, still occupied.) The boss laughs (a rather disgusting laugh) and smiles. "Ah, I knew the military'd send someone for me someday...I just didn't expect you lot to find me so soon." You and Roy look at each other, remembering your mission: to bring Mr. Boss back alive for questioning.

You can see a boss here.

Roy follows you here.

>n
You can't go that way.

>w
You can't go that way.

>e
You can't go that way.

>s
VII
You can see Corner table and Flower pot here.

Roy follows you here.

>n
VIII
Together, you and Zakarius burst through the door into the boss" room, and run to restrain him. (Fortunately for you, the guards are, apparently, still occupied.) The boss laughs (a rather disgusting laugh) and smiles. "Ah, I knew the military'd send someone for me someday...I just didn't expect you lot to find me so soon." You and Roy look at each other, remembering your mission: to bring Mr. Boss back alive for questioning.

You can see a boss here.

Roy follows you here.

>n
You can't go that way.

>n
You can't go that way.

>hit boss with sword
I only understood you as far as wanting to hit the boss.

>hit boss
Violence isn't the answer to this one.

You whack the boss in the head, knocking him out.

>hit boss
Violence isn't the answer to this one.

You whack the boss in the head, knocking him out.

>hit boss with sword
I only understood you as far as wanting to hit the boss.

* * *

>x plant
Two small potted plants. After checking the pots, you discover a bit! You put the bit in your pocket.

>n
I
You listen through the door to make sure no one`s guarding the other side. . .Nope. You carefully slip past the threshold into the first room. You see a few lockers here. You assume they are for the guards. The exit is to the west and back south.

Roy follows you here.

>e
You can't go that way.

>n
You can't go that way.

>spin dial to 507
"CLICK" The lockers are now unlocked. You can see Handcuffs and Piece of cake.

>s
Entrance
A petite room with black and white checkerboard-style tiles, and grey walls. There is a plant on either side of the doorway, and three narrow windows. The exit is to the north.

Roy follows you here.

>w
You can't go that way.

* * *

>e
You can't go that way.

>s
You can't go that way.

>n
I
You listen through the door to make sure no one`s guarding the other side. . .Nope. You carefully slip past the threshold into the first room. You see a few lockers here. You assume they are for the guards. The exit is to the west and back south.

Roy follows you here.

>i
You are carrying:
  Bit

>spin dial to 507
You hear a "Click", but nothing else happens.

>spin dial to 507
You hear a "Click", but nothing else happens.

>i
You are carrying:
  Bit

* * *

>spin dial to 507
"CLICK" The lockers are now unlocked. You can see Handcuffs and Piece of cake.

>take handcuffs
Taken.

>w
II
The exit is to the west and back east.

Roy follows you here.

* * *

>s
V
One of the walls is lined with computers-you assume that this is the makeshift HQ's research room. You see a 3D printer blocked off by a rope.

You can see 3D printer here.

Roy follows you here.

>e
VI
You and Roy peer in through the opening made by the slightly ajar door...and see a handful of guards! So that's where they all went! If only there were a way to distract them...maybe if you placed something by the door, its smell would get their attention...

Roy follows you here.

>n
VII
You can see Corner table and Flower pot here.

Roy follows you here.

>look under plant
You can't see any such thing.

>look under pot
You find a pin! You pocket the pin.

>combine pin with bit
You fit the bit into the pin and voila! Now you have a key!

>unlock door with key
You unlock Final door.

* * *

>n
VII
You can see Corner table and Flower pot here.

Roy follows you here.

>look under pot
You find a pin! You pocket the pin.

>combine bit with pin
You fit the bit into the pin and voila! Now you have a key!

>unlock door with key
You unlock Final door.

* * *

>n
(first opening Final door)

VIII
Together, you and Zakarius burst through the door into the boss" room, and run to restrain him. (Fortunately for you, the guards are, apparently, still occupied.) The boss laughs (a rather disgusting laugh) and smiles. "Ah, I knew the military'd send someone for me someday...I just didn't expect you lot to find me so soon." You and Roy look at each other, remembering your mission: to bring Mr. Boss back alive for questioning.

You can see a boss here.

Roy follows you here.

>use handcuffs on boss
You handcuff the boss, making it easy for you and Zakarius to drag him back to HQ.

    *** The End ***

Would you like to RESTART, RESTORE a saved game, QUIT or UNDO the last command?

>i
Please give one of the answers above.

Would you like to RESTART, RESTORE a saved game, QUIT or UNDO the last command?

>use handcuffs
Please give one of the answers above.

Would you like to RESTART, RESTORE a saved game, QUIT or UNDO the last command?

>tie handcuffs to boss
Please give one of the answers above.

Would you like to RESTART, RESTORE a saved game, QUIT or UNDO the last command?

>undo
VIII
[Previous turn undone.]

>use handcuffs on boss
You handcuff the boss, making it easy for you and Zakarius to drag him back to HQ.

    *** The End ***

Would you like to RESTART, RESTORE a saved game, QUIT or UNDO the last command?

>use handcuffs on the boss
Please give one of the answers above.

Would you like to RESTART, RESTORE a saved game, QUIT or UNDO the last command?

>l
Please give one of the answers above.

Would you like to RESTART, RESTORE a saved game, QUIT or UNDO the last command?

>use handcuffs on boss
Please give one of the answers above.

Would you like to RESTART, RESTORE a saved game, QUIT or UNDO the last command?

>use handcuffs on the boss
Please give one of the answers above.

Would you like to RESTART, RESTORE a saved game, QUIT or UNDO the last command?

>undo
VIII
[Previous turn undone.]

>use handcuffs on the boss
You handcuff the boss, making it easy for you and Zakarius to drag him back to HQ.

    *** The End ***

Would you like to RESTART, RESTORE a saved game, QUIT or UNDO the last command?

>undo
VIII
[Previous turn undone.]

>x handcuffs
A pair of handcuffs. Roy has the cuff key. You can use them on something.

* * *

>spin dial to 507
"CLICK" The lockers are now unlocked. You can see Handcuffs and Piece of cake.

>take cake and handcuffs
Piece of cake: Taken.
Handcuffs: Taken.

>w
II
What looks like a meeting room...there are a few seats, a desk, and a whiteboard/projector screen. The exit is to the west and back east.

You can see Seats, Desk and White board here.

Roy follows you here.

>w
III
A rather empty storage room. Hmm. Must be one of their newer hideouts. The exit is to the north and back east.

You can see Boxes (closed) here.

Roy follows you here.

>s
V
One of the walls is lined with computers-you assume that this is the makeshift HQ`s research room. You see a 3D printer blocked off by a rope.

You can see 3D printer here.

Roy follows you here.

* * *

>e
VI
A spacious room.  All of the guards are gathered here. You can`t let them see you, as you can`t let yourself get caught. Maybe you can get them out of here if you dropped something... 

You can see Guards here.

Roy follows you here.

>drop cake
You drop half of the piece of cake and hide. The guards notice right away the delectable scent, and near the door to investigate. One of them steps forward, "Hey! My slice of cake! Actually, guys, isn`t it lunch time?" The guards take off to room IV, and you and Roy enter the code (RGB) to sneak off to the next room.

>n
That`s one heck of a piece of cake...apparently the guards are still distracted.

(first opening Hallway door)

VII
A simple hallway. There were a few windows, but they are now blocked up. The exit is back south and to the north.

You can see Corner table and Flower pot here.

Roy follows you here.

>look under pot
You find a pin! You pocket the pin.

* * *

>combine bit with pin
You fit the bit into the pin and voila! Now you have a key!

>n
(first opening Final door)
It seems to be locked.

>unlock door with key
Which do you mean, Hallway door or Final door?

>unlock final door with key
You unlock Final door.

>n
(first opening Final door)

VIII
Together, you and Zakarius burst through the door into the boss` room, and run to restrain him. (Fortunately for you, the guards are, apparently, still occupied.) The boss laughs (a rather disgusting laugh) and smiles. "Ah, I knew the military`d send someone for me someday...I just didn`t expect you lot to find me so soon." You and Roy look at each other, remembering your mission: to bring Mr. Boss back alive for questioning.

You can see a boss here.

Roy follows you here.

>use handcuffs on boss
    *** You handcuff the boss, making it easy for you and Zakarius to drag him back to HQ. ***

Would you like to RESTART, RESTORE a saved game, QUIT or UNDO the last command?

* * *

>spin dial to 507
"CLICK" The lockers are now unlocked. You can see Handcuffs and Piece of cake.

>take handcuffs and cake
Handcuffs: Taken.
Piece of cake: Taken.

>w
II
What looks like a meeting room...there are a few seats, a desk, and a whiteboard/projector screen. The exit is to the west and back east.

You can see Seats, Desk and White board here.

Roy follows you here.

>n
You can't go that way.

>s
You can't go that way.

>w
III
A rather empty storage room. Hmm. Must be one of their newer hideouts. The exit is to the north and back east.

You can see Boxes (closed) here.

Roy follows you here.

* * *

>s
V
One of the walls is lined with computers-you assume that this is the makeshift HQ`s research room. You see a 3D printer blocked off by a rope.

You can see 3D printer here.

Roy follows you here.

>n
III
A rather empty storage room. Hmm. Must be one of their newer hideouts. The exit is to the north and back east.

You can see Boxes (closed) here.

Roy follows you here.

>n
IV
What appears to be the guards` break room. A simple, clean room with a few tables and chairs for the base`s security guards to rest on. There is a counter along the wall across the door. Apparently it is not break time yet. The exit is back south.

You can see Tables and Chairs here.

Roy follows you here.

>x tables
You scan the tables to check for any clues the guards carelessly left behind. Unfortunately, there are no clues to be found.

>x chairs
You check each chair for anything that might have fallen out of the guards` pockets. On one chair, you find a pack of cigarettes with an R, a G, and a B written on the outside. Maybe it`s a code to unlock something? "Hey, you found cigarettes! Mind sharing?" asks Roy, as he grabs hold of the cigarette pack...along with your hand holding the pack. It appears you must give him a cigarette before he releases your hand. Strangely, it feels awfully light. Maybe you should check inside?

>open cigarette pack
"WHAT?! WHAT THE HEAK ARE THOSE M&Ms DOING IN THERE?" Roy releases you in favor of throwing his hands above his head in frustration.  You look at Roy, a blank expression plastered on your face. You see a green M&M, a blue M&M, and a red M&M.

* * *

>x cigarette pack
"WHAT?! WHAT THE HEAK ARE THOSE M&Ms DOING IN THERE?" Roy releases you in favor of throwing his hands above his head in frustration.  You look at Roy, a blank expression plastered on your face. You see a green M&M, a blue M&M, and a red M&M.

>x counter
A marble counter. On top of it are stacks of cups, two coffee machines, napkins, a tub of marshmallows, and a mysterious, opened soup can.

>x cups
Disposable heat-resistant cups

>take cups
A stack of cups...however, you don't think you`ll need them for this mission, so you decide to leave them.

>x coffee machines
Two kick-ass coffee machines...too bad you don't like coffee...

>take machines
I know you`re a super agent and all, but how do you plan to be all stealthy-like if you`ve got those two silly machines in your arms?

>x soup can
"Where`s the label?" asks Roy. As he nears the counter to inspect the can, he trips on your foot and goes crashing into the counter, knocking the soup can onto the floor. He picks it up, but you should check the floor to make sure he didn`t make a mess. The guards can`t know you`ve been here.

>x floor
You don`t see any spillage, but you do spot a piece of paper lying on the floor. You pick up the paper.

>x paper
What appears to be the torn-off label from a spaghetti-o`s can. You turn it over and see numbers on the back. It reads "507".

* * *

>x plant
Two small potted plants. After checking the pots, you discover a bit! You put the bit in your pocket.

>x roy
Roy Zakarius is your (flirtatious) colleague.

>make love to roy
That's not a verb I recognise.

>touch roy
Roy Zakarius might not like that.

>Touch roy
Roy Zakarius might not like that.

>i
You are carrying:
  Bit

>x bit
It looks like it'd fit into something through the process of combining...

* * *

>i
You are carrying:
  Bit

>l
Entrance
A petite room with black and white checkerboard-style tiles, and grey walls. There is a plant on either side of the doorway, and three narrow windows. The exit is to the north.

You can see Roy Zakarius here.

>x tile
You can't see any such thing.

>x tiles
Simple, expensive-looking tiles. Nothing suspicious.

>x walls
You can't see any such thing.

>n
I
You listen through the door to make sure no one's guarding the other side. . .Nope. You carefully slip past the threshold into the first room. You see a few lockers here. You assume they are for the guards. The exit is to the west and back south.

Roy follows you here.

>s
Entrance
A petite room with black and white checkerboard-style tiles, and grey walls. There is a plant on either side of the doorway, and three narrow windows. The exit is to the north.

Roy follows you here.

>x windows
You see a lot of trees. That is all.

>s
You can't go that way.

>n
I
You listen through the door to make sure no one's guarding the other side. . .Nope. You carefully slip past the threshold into the first room. You see a few lockers here. You assume they are for the guards. The exit is to the west and back south.

Roy follows you here.

>x lockers
A simple set of lockers. To open them you must spin the dial to the correct number.  (Hint: when entering the numbers, type them in as a single number.)

>1234
That's not a verb I recognise.

>spin dial to 1234
You hear a "Click", but nothing else happens.

>spin dial to 1111
You hear a "Click", but nothing else happens.

I beg your pardon?

>l
I
You listen through the door to make sure no one's guarding the other side. . .Nope. You carefully slip past the threshold into the first room. You see a few lockers here. You assume they are for the guards. The exit is to the west and back south.

You can see Roy Zakarius here.

>w
II
The exit is to the west and back east.

Roy follows you here.

* * *

>w
III
The exit is to the north and back east.

Roy follows you here.

>n
IV room
What appears to be the guards` break room. A simple, clean room with a few tables and chairs for the base's security guards to rest on. There is a counter along the wall across the door. Apparently it is not break time yet. The exit is back south.

You can see Tables and Chairs here.

Roy follows you here.

>x tables
You scan the tables to check for any clues the guards carelessly left behind. Unfortunately, there are no clues to be found.

>chairs
That's not a verb I recognise.

>x chair
You check each chair for anything that might have fallen out of the guards" pockets. On one chair, you find a pack of cigarettes. "Hey, you found cigarettes! Mind sharing?" asks Roy, as he grabs hold of the cigarette pack...along with your hand holding the pack. It appears you must give him a cigarette before he releases your hand. Strangely, it feels awfully light. Maybe you should check inside?

>make love to roy
That's not a verb I recognise.

>w
You can't go that way.

* * *

>e
You can't go that way.

>s
III
The exit is to the north and back east.

Roy follows you here.

>n
IV room
What appears to be the guards` break room. A simple, clean room with a few tables and chairs for the base's security guards to rest on. There is a counter along the wall across the door. Apparently it is not break time yet. The exit is back south.

You can see Tables and Chairs here.

Roy follows you here.

>l
IV room
What appears to be the guards` break room. A simple, clean room with a few tables and chairs for the base's security guards to rest on. There is a counter along the wall across the door. Apparently it is not break time yet. The exit is back south.

You can see Roy Zakarius, Tables and Chairs here.

>give roy cigarette
Roy Zakarius doesn't seem interested.

>give roy cigarettes
Roy Zakarius doesn't seem interested.

>i
You are carrying:
  Cigarette pack
  Bit

>give Roy Cigarette Pack
Roy Zakarius doesn't seem interested.

>x counter
A marble counter. On top of it are stacks of disposable, heat-resistant cups, two coffee machines, napkins, a tub of marshmallows, and a mysterious, opened soup can.

>take marshmellows
You can't see any such thing.

>take tub of marshmallows
You can't see any such thing.

>take marshmallows
You can't see any such thing.

>take napkins
You can't see any such thing.

>take coffee machines
You can't see any such thing.

>take cups
You can't see any such thing.

>take soup can
You'll need to leave this here. If you take it, the guards might realize your presence.

>x soup can
"Where's the label?" asks Roy. As he nears the counter to inspect the can, he trips on your foot and goes crashing into the counter, knocking the soup can onto the floor. He picks it up, but you should check the floor to make sure he didn't make a mess. The guards can't know you've been here.

>x floor
You don't see any spillage, but you do spot a piece of paper lying on the floor. You pick up the paper.

>i
You are carrying:
  Piece of paper
  Cigarette pack
  Bit

>x paper
What appears to be the torn-off label from a spaghetti-o's can. You turn it over and see numbers on the back. It reads "507".

>l
IV room
What appears to be the guards` break room. A simple, clean room with a few tables and chairs for the base's security guards to rest on. There is a counter along the wall across the door. Apparently it is not break time yet. The exit is back south.

You can see Roy Zakarius, Tables and Chairs here.

>s
III
The exit is to the north and back east.

Roy follows you here.

>e
II
The exit is to the west and back east.

Roy follows you here.

>e
I
You listen through the door to make sure no one's guarding the other side. . .Nope. You carefully slip past the threshold into the first room. You see a few lockers here. You assume they are for the guards. The exit is to the west and back south.

Roy follows you here.

>spin dial to 507
"CLICK" The lockers are now unlocked. You can see Handcuffs and Piece of cake.

>eat piece of cake
That's plainly inedible.

>take handcuffs
Taken.

>take cake
Taken.

>x handcuffs
A pair of handcuffs. Roy has the cuff key. You can use them on something.

>cake
That's not a verb I recognise.

>x cake
It smells delicious. So good, that it could distract one from doing work.

>eat the cke
You can't see any such thing.

>eat cake
That's plainly inedible.

>give cake to roy
Roy Zakarius doesn't seem interested.

>use handcuffs on roy
You would achieve nothing by this.

>w
II
The exit is to the west and back east.

Roy follows you here.

* * *

>w
III
The exit is to the north and back east.

Roy follows you here.

>w
You can't go that way.

>n
IV room
What appears to be the guards` break room. A simple, clean room with a few tables and chairs for the base's security guards to rest on. There is a counter along the wall across the door. Apparently it is not break time yet. The exit is back south.

You can see Tables and Chairs here.

Roy follows you here.

>s
III
The exit is to the north and back east.

Roy follows you here.

* * *

>e
I
You listen through the door to make sure no one's guarding the other side. . .Nope. You carefully slip past the threshold into the first room. You see a few lockers here. You assume they are for the guards. The exit is to the west and back south.

Roy follows you here.

>s
Entrance
A petite room with black and white checkerboard-style tiles, and grey walls. There is a plant on either side of the doorway, and three narrow windows. The exit is to the north.

Roy follows you here.

>n
I
You listen through the door to make sure no one's guarding the other side. . .Nope. You carefully slip past the threshold into the first room. You see a few lockers here. You assume they are for the guards. The exit is to the west and back south.

Roy follows you here.

>w
II
The exit is to the west and back east.

Roy follows you here.

* * *

>s
V
One of the walls is lined with computers-you assume that this is the makeshift HQ's research room. You see a 3D printer blocked off by a rope.

You can see 3D printer here.

Roy follows you here.

>x rope
You untie the rope from the poles and take it with you.

>i
You are carrying:
  Rope
  Piece of cake
  Handcuffs
  Piece of paper
  Cigarette pack
  Bit

>x rope
A thick rope that you can tie to  something.

>x printer
There is a sign on it that reads, "Only prints plastic swords. Use at your own risk." There is a strange sound, and out pops a plastic sword.

>take sword
Taken.

>hit roy with sword
You can't see any such thing.

>use sword
You can't see any such thing.

>i
You are carrying:
  Plastic sword
  Rope
  Piece of cake
  Handcuffs
  Piece of paper
  Cigarette pack
  Bit

>hit roy with plastic sword
You can't see any such thing.

>i
You are carrying:
  Plastic sword
  Rope
  Piece of cake
  Handcuffs
  Piece of paper
  Cigarette pack
  Bit

>x sword
Extremely light-weight, and slightly bendable. You can probably crack it in half with your bare hands.

>crack sword in half
You can't see any such thing.

>e
VI
You and Roy peer in through the opening made by the slightly ajar door...and see a handful of guards! So that's where they all went! If only there were a way to distract them...maybe if you placed something by the door, its smell would get their attention...

Roy follows you here.

>drop cake
You drop the cake and hide. The guards notice right away the delectable scent, and near the door to investigate. One of them steps forward, "Hey! My slice of cake! Actually, guys, isn't it lunch time?" The guards take off to room IV.

>l
VI
You and Roy peer in through the opening made by the slightly ajar door...and see a handful of guards! So that's where they all went! If only there were a way to distract them...maybe if you placed something by the door, its smell would get their attention...

You can see Roy Zakarius here.

>n
VII
A simple hallway. The exit is back south and to the north.

You can see Corner table and Flower pot here.

Roy follows you here.

>x table
A simple corner table with a flower pot on top.

>x pot
A pot holding a marigold. The pot seems unbalanced, as if something is awkwardly lifting one side.

>look under the pot
You find a pin! You pocket the pin.

>i
You are carrying:
  Pin
  Plastic sword
  Rope
  Handcuffs
  Piece of paper
  Cigarette pack
  Bit

>x pin
It has a pocket that something can be inserted in through combining.

>x bit
It looks like it'd fit into something through the process of combining...

>combine bit with pin
You fit the bit into the pin and voila! Now you have a key!

>i
You are carrying:
  Key
  Plastic sword
  Rope
  Handcuffs
  Piece of paper
  Cigarette pack

>x key
Use it to unlock something...

>l
VII
A simple hallway. The exit is back south and to the north.

You can see Roy Zakarius, Corner table and Flower pot here.

>n
(first opening Final door)
It seems to be locked.

>unlock door
What do you want to unlock Final door with?

>unlock door with key
You unlock Final door.

* * *

>n
(first opening Final door)

VIII
Together, you and Zakarius burst through the door into the boss" room, and run to restrain him. (Fortunately for you, the guards are, apparently, still occupied.) The boss laughs (a rather disgusting laugh) and smiles. "Ah, I knew the military'd send someone for me someday...I just didn't expect you lot to find me so soon." You and Roy look at each other, remembering your mission: to bring Mr. Boss back alive for questioning.

You can see a boss here.

Roy follows you here.

>i
You are carrying:
  Key
  Plastic sword
  Rope
  Handcuffs
  Piece of paper
  Cigarette pack

>use rope on boss
You can't see any such thing.

>hit boss
You whack the boss in the head, knocking him out. You and Zakarius easily drag him back to HQ.

    *** The End ***

Would you like to RESTART, RESTORE a saved game, QUIT or UNDO the last command?

>undo
VIII
[Previous turn undone.]

>tie boss with rope
I didn't understand that sentence.

>undo
VIII
[Previous turn undone.]

>tie up boss with rope
I didn't understand that sentence.

>tie rope to boss
You tie the boss up, making it easy for you and Zakarius to drag him back to HQ.

    *** The End ***

Would you like to RESTART, RESTORE a saved game, QUIT or UNDO the last command?

* * *

>x plant
Two small potted plants. After checking the pots, you discover a bit! You put the bit in your pocket.

>x bit
It looks like it`d fit into something through the process of combining...

>x roy
Roy Zakarius is your (flirtatious) colleague.

>ask roy about bit
"I think that's part of a key. It connects to the pin of the key."

>ask roy about plant
There is no reply.

>ask roy about room
There is no reply.

>talk to rot
You can't see any such thing.

>talk to roy
"Do you maybe wanna grab dinner after this?"

* * *

>talk to roy
"Seriously, I know this really good Filipino place. They have the greatest adobo."

>l
entrance
A petite room with black and white checkerboard-style tiles, and grey walls. There is a plant on either side of the doorway, and three narrow windows. The exit is to the north.

You can see Roy Zakarius here.

>x windows
You see a lot of trees. That is all.

>xtiles
That's not a verb I recognise.

>x tiles
Simple, expensive-looking tiles. Nothing suspicious.

>n
I
You listen through the door to make sure no one`s guarding the other side. . .Nope. You carefully slip past the threshold into the first room. You see a few lockers here. You assume they are for the guards. The exit is to the west and back south.

Roy follows you here.

>open locker
They`re locked.

>open lockers
They`re locked.

>x lockers
A simple set of lockers. To open them you must spin the dial to the correct number.  (Hint: when entering the numbers, type them in as a single number. (spin dial to ###) )

>000
That's not a verb I recognise.

>l
I
You listen through the door to make sure no one`s guarding the other side. . .Nope. You carefully slip past the threshold into the first room. You see a few lockers here. You assume they are for the guards. The exit is to the west and back south.

You can see Roy Zakarius here.

>w
II
What looks like a meeting room...there are a few seats, a desk, and a whiteboard/projector screen. The exit is to the west and back east.

You can see Seats, Desk and White board here.

Roy follows you here.

>x desk
Fancy table...

>x seats
Very fancy seats...

>sit in seats
You are a powerful military intelligencer. You do not need to sit. Meanwhile, you see Roy spinning around in one of the fancy chairs.

>x whiteboard
It has a really nice hawk drawing on it with "ALCO" written beneath it.

>x white board
It has a really nice hawk drawing on it with "ALCO" written beneath it.

>x hawk
A tribal-style drawing of a hawk.

>open desk
It isn't something you can open.

>l
II
What looks like a meeting room...there are a few seats, a desk, and a whiteboard/projector screen. The exit is to the west and back east.

You can see Roy Zakarius, Seats, Desk and White board here.

>w
III
A rather empty storage room. Hmm. Must be one of their newer hideouts. The exit is to the north, south, and back east.

You can see Boxes (closed) here.

Roy follows you here.

>open boxes
You open Boxes, revealing Computer Science for Dummies book.

>take book
Taken.

>read book
Huh. Interesting. You don't know how much this'd be of help, though, since you are already quite fluent in java, ruby, and python.

>l
III
A rather empty storage room. Hmm. Must be one of their newer hideouts. The exit is to the north, south, and back east.

You can see Roy Zakarius and Boxes (empty) here.

>n
IV
What appears to be the guards` break room. A simple, clean room with a few tables and chairs for the base`s security guards to rest on. There is a counter along the wall across the door. Apparently it is not break time yet. The exit is back south.

You can see Tables and Chairs here.

Roy follows you here.

>x counter
A marble counter. On top of it are stacks of cups, two coffee machines, a tub of marshmallows, and a mysterious, opened soup can.

>take all
There are none at all available!

>take cups
A stack of cups...however, you don't think you`ll need them for this mission, so you decide to leave them.

>take napkins
You can't see any such thing.

>take marshmallows
Yum...you haven`t had marshmallows since...middle school!

>x soup can
"Where`s the label?" asks Roy. As he nears the counter to inspect the can, he trips on your foot and goes crashing into the counter, knocking the soup can onto the floor. He picks it up, but you should check the floor to make sure he didn`t make a mess. The guards can`t know you`ve been here.

* * *

>x paper
What appears to be the torn-off label from a spaghetti-o`s can. You turn it over and see numbers on the back. It reads "507".

>s
III
A rather empty storage room. Hmm. Must be one of their newer hideouts. The exit is to the north, south, and back east.

You can see Boxes (empty) here.

Roy follows you here.

>s
V
One of the walls is lined with computers-you assume that this is the makeshift HQ`s research room. You see a 3D printer blocked off by a rope. The exit is back north and to the east.

You can see 3D printer here.

Roy follows you here.

>x printer
There is a sign on it that reads, "Only prints plastic swords. Use at your own risk." Roy quickly pushes the button without hesitation. There is a strange sound, and out pops a plastic sword.

>take sword
Taken.

>x sword
Extremely light-weight, and slightly bendable. You can probably crack it in half with your bare hands.

>breaksword
That's not a verb I recognise.

>break sword
Violence isn't the answer to this one.

>s
You can't go that way.

>l
V
One of the walls is lined with computers-you assume that this is the makeshift HQ`s research room. You see a 3D printer blocked off by a rope. The exit is back north and to the east.

You can see Roy Zakarius and 3D printer here.

>w
You can't go that way.

>e
VI
A spacious room.  All of the guards are gathered here. You can`t let them see you, as you can`t let yourself get caught. Maybe you can get them out of here if you dropped something... The exit is back west, and to the north. 

You can see Guards here.

Roy follows you here.

>e
You can't go that way.

>l
VI
A spacious room. The exit is back west, and to the north. (Hint: check the description from the first time you visited VI)

You can see Roy Zakarius and Guards here.

>i
You are carrying:
  Plastic sword
  Piece of paper
  Computer Science for Dummies book
  Bit

>drop book
Dropped.

>l
VI
A spacious room. The exit is back west, and to the north. (Hint: check the description from the first time you visited VI)

You can see Computer Science for Dummies book, Roy Zakarius and Guards here.

>e
You can't go that way.

>w
V
One of the walls is lined with computers-you assume that this is the makeshift HQ`s research room. You see a 3D printer blocked off by a rope. The exit is back north and to the east.

You can see 3D printer here.

Roy follows you here.

>n
III
A rather empty storage room. Hmm. Must be one of their newer hideouts. The exit is to the north, south, and back east.

You can see Boxes (empty) here.

Roy follows you here.

>s
V
One of the walls is lined with computers-you assume that this is the makeshift HQ`s research room. You see a 3D printer blocked off by a rope. The exit is back north and to the east.

You can see 3D printer here.

Roy follows you here.

>s
You can't go that way.

>w
You can't go that way.

>e
VI
A spacious room. The exit is back west, and to the north. (Hint: check the description from the first time you visited VI)

You can see Computer Science for Dummies book and Guards here.

Roy follows you here.

>n
Despite your and Roy`s exceptional skill, you don`t think you can take all of these guys at once...especially when they each have all of that equipment...

>s
You can't go that way.

>s
You can't go that way.

>w
V
One of the walls is lined with computers-you assume that this is the makeshift HQ`s research room. You see a 3D printer blocked off by a rope. The exit is back north and to the east.

You can see 3D printer here.

Roy follows you here.

>w
You can't go that way.

* * *

>e
VI
A spacious room. The exit is back west, and to the north. (Hint: check the description from the first time you visited VI)

You can see Computer Science for Dummies book and Guards here.

Roy follows you here.

>e
You can't go that way.

>e
You can't go that way.

>n
Despite your and Roy`s exceptional skill, you don`t think you can take all of these guys at once...especially when they each have all of that equipment...

>n
Despite your and Roy`s exceptional skill, you don`t think you can take all of these guys at once...especially when they each have all of that equipment...

>w
V
One of the walls is lined with computers-you assume that this is the makeshift HQ`s research room. You see a 3D printer blocked off by a rope. The exit is back north and to the east.

You can see 3D printer here.

Roy follows you here.

* * *

>n
III
A rather empty storage room. Hmm. Must be one of their newer hideouts. The exit is to the north, south, and back east.

You can see Boxes (empty) here.

Roy follows you here.

>n
IV
What appears to be the guards` break room. A simple, clean room with a few tables and chairs for the base`s security guards to rest on. There is a counter along the wall across the door. Apparently it is not break time yet. The exit is back south.

You can see Tables and Chairs here.

Roy follows you here.

>n
You can't go that way.

>e
You can't go that way.

>w
You can't go that way.

>s
III
A rather empty storage room. Hmm. Must be one of their newer hideouts. The exit is to the north, south, and back east.

You can see Boxes (empty) here.

Roy follows you here.

>e
II
What looks like a meeting room...there are a few seats, a desk, and a whiteboard/projector screen. The exit is to the west and back east.

You can see Seats, Desk and White board here.

Roy follows you here.

>e
I
You listen through the door to make sure no one`s guarding the other side. . .Nope. You carefully slip past the threshold into the first room. You see a few lockers here. You assume they are for the guards. The exit is to the west and back south.

Roy follows you here.

>x lokers
You can't see any such thing.

>x lockers
A simple set of lockers. To open them you must spin the dial to the correct number.  (Hint: when entering the numbers, type them in as a single number. (spin dial to ###) )

>spin 507
You can't see any such thing.

>spin dial
I didn't understand that sentence.

>enter 507
You can't see any such thing.

>507
That's not a verb I recognise.

>dial 507
That's not a verb I recognise.

>open 507
You can't see any such thing.

>x dial
A simple set of lockers. To open them you must spin the dial to the correct number.  (Hint: when entering the numbers, type them in as a single number. (spin dial to ###) )

>507
That's not a verb I recognise.

>spin dial to 507
"CLICK" The lockers are now unlocked. You can see Handcuffs and Piece of cake.

* * *

>spin dial to 507
You can't see any such thing.

>n
I
You listen through the door to make sure no one's guarding the other side. . .Nope. You carefully slip past the threshold into the first room. You see a few lockers here. You assume they are for the guards. The exit is to the west and back south.

Roy follows you here.

>spin dial to 507
"CLICK" The lockers are now unlocked. You can see Handcuffs and Piece of cake.

* * *

>take cake
Taken.

>n
You can't go that way.

>w
II
The exit is to the west and back east.

Roy follows you here.